NO ./textures/brick1.png
EA ./textures/brick2.png
SO ./textures/brick3.png
WE ./textures/brick4.png


C 0,255,255
F 0,255,0


11111111111
 100000001
  1000001
   10001
    1W1
     1
