NO ./textures/brick1.png
EA ./textures/brick2.png
SO ./textures/brick3.png
WE ./textures/brick4.png
C 0,255,0
F 0,0,0

11111111111111111
1000000000000000111
1010000010000010111111 111111
1000000000000000111S01 1000001
1000100010001000111111   101 
10000000000000001         1
10101010001010101
10000000000000001
10001000100100001
10000000000000001
10100000100001001
10000000000000001
11111011111111111
    101         
1111101111111111
10000000000000001
10100000100000101
10000000000000011
100010001000101
10000000000000011
10101010001010101
10000000000000001
10001000100100001
10000000000000001
10100000100001001
10000000000000001
11111111111111111
